numCheckpoints 6 
0 113 1964 325 2162 113 1964 1 0 
1 717 85 975 347 816 85 2 0 
2 2925 1912 3198 2235 3044 1912 3 0 
3 3234 881 3512 1143 3234 881 4 0 
4 1043 368 1294 694 1043 368 5 0 
5 1 1 1 1 1 1 0 
