numCheckpoints 11 
0 320 560 600 688 320 500 1 0 
1 650 900 1300 988 710 850 2 0 
2 3070 900 3792 988 3092 960 3 0 
3 3000 200 3100 288 3000 224 4 0 
4 651 200 825 288 811 224 5 6 0 
5 650 900 1300 988 710 850 7 0 
6 3000 200 3100 288 3000 224 7 0 
7 3264 1300 3344 1388 3264 1244 8 0 
8 416 1300 1037 1388 937 1244 9 0 
9 2912 1300 3336 1388 3083 1244 10 0 
10 1 1 1 1 1 1 0 
