numCheckpoints 6 
0 506 107 774 314 560 50 1 0 
1 1851 158 1970 350 1729 172 2 0 
2 1827 498 2073 703 1827 498 3 0 
3 3962 499 4170 700 3962 499 4 0 
4 6444 532 6674 733 6444 532 5 0 
5 1 1 1 1 1 1 0 
